27 10
000000000000000000000000000
000000000000000000000000000
000000000000000000000000000
000000000000000000000000000
000000000000000000000000000
000010000000000000000000000
000011100000000000000000000
000000000010000010000111100
000000000111000101000100100
111111111111101000111111111
