54 10
000000000000000000000000000000000000000000000000000000
000000000000000000000000000000010101001010010000000000
000000000000000000000000000000011000110010110000000000
000000000000000001111111111000100101100011010000000000
000000000000000000000000000000000000100001000000000000
000010000000000000000000000100010000000001111000000000
000011100000000000000000100000011100000000001111110000
000000000010000010000111100000000000010000010000111100
000000000111000101000100100000000000111000101000100100
111111111111101000111111111111111111111101000111111111
