110 10
00000000000000000000000000000000000000000000000000000000000000000000000000000000000000000000000000000000000000
00000000000000000000000000000001010100101001000000000000000000000000000000100001010000010101110100000000000000
00000000000000000000000000000001100011001011000000000000000000000000000000010010001000100100001100000000000000
00000000000000000111111111100010010110001101000000000000000000000000000000001100000101000100010100000000000000
00000000000000000000000000000000000010000100000000000000000000000000011000001100000010000100100100000000000000
00000000000000000000000000010001000000000111100000000000000000000001001000010010000100000101000100000000000000
00000000000000000000000010000001110000000000111111000000000000000100000100100001001000000110000100000000000000
00000000001000001111011110000000000001000001000011110000000000010000000000100000000000000000000000000000000000
00000000011100100001010010000000000011100010100010010000000010000000000000000001000000000000000000000000000000
11111111111110100001111111111111111111110100011111111111111111111111111111111111111111111111111111111111111111
