20 6
00000000000000000000
00000000000000000000
00000000000001000111
00010000000111111111
11111110011111111111
