64 10
0000000000000000000000000000000000000000000000000000000000000000
0000000000000000000000000000000101010010100100000000000000000000
0000000000000000000000000000000110001100101100000000000000000000
0000000000000000011111111110001001011000110100000000000000000000
0000000000000000000000000000000000001000010000000000000000000000
0000100000000000000000000001000100000000011110000000000000000000
0000111000000000000000001000000111000000000011111100000000000000
0000000000100000111101111000000000000100000100001111000000000000
0000000001110010000101001000000000001110001010001001000000000000
1111111111111010000111111111111111111111010001111111111111111111
